


	
	מחידושי־המילים של בן־אב"י שבאו בספר זה
	



איון – אי קטן

אל־עולות – בלי עול, עצמאות

אירעון – אינצידנט

אמיר־הים – אדמירל

בדרך יצרית – אינסטינקטיבית

בריתיה – פדרציה

גמש, התגמש – פועל מן השם גמישות

דהימה – תדהמה

דוריי – בעל חשיבות לדורות (מלשון “דור”)

היזדורי – היסטורי

הסתלחות – סלחנות הדדית

השהיד – העיד (“שהדי במרומים”)

התהבנות – הבנה הדדית

התהמנות – התנהגות זולה, וולגארית

התלאם – ליהפך ללאום, לנכס לאומי

התלייל – למצוא מקלט לילה

התרעה – בקול תרועה, במחיאות־כפיים סואנות

וזרה – מיניסטריון, ממשלה

וזיר – שר

זהבית (או תפוז) – תפוח־זהב

יהודאי – אזרח יהודה העצמאית

יעורת – חורשה

ישבנות – קולוניזציה

כנסיה – קונגרס

לאוט – איטי

לחיש – נמוך־קול (מלשון “לחש”)

לעלן – נייטרלי (“לא עם לא נגד”, מחידושי אליעזר בן־יהודה)

מאון – מאה שנה

מאחדה – קואליציה

מגינה – מיליציה

מדחה – דחיה

מואבת (או אבותיה, או אביה) – מולדת (מלשון “ארץ־אב”)

מורשון – פארלמנט, בית־נבחרים

מלאכות – משלחת

ממודן – חדיש, מודרני

ממונות – מנדט

מנאם – נאום

מסדרה – הסתדרות, ארגון

מפגעה – פגע, מכשלה

מפולד – עשוי פלדה

מקברה – בית־קברות

מרחייל – מצביא

מרעיר – ראש־עיר

נטיינית – חד־צדדית, בעלת משוא־פנים

נמנומת – שינה קלה

עוזמה – עוז־רוח

עמוני – דמוקראט

קהוואה – בית־קפה

קהליי – רפובליקני

רכושן ־ קאפיטליסט






את הטקסט לעיל הפיקו מתנדבי פרויקט בן־יהודה באינטרנט.  הוא זמין תמיד בכתובת הבאה:https://benyehuda.org/read/15245